2	3	3	3	3	3	3	3	3	3	3	3	3	3	3	4
5	6	6	6	7	8	9	8	10	8	11	8	9	6	6	12
5	6	6	6	13	6	6	6	13	6	6	6	13	6	6	12
5	8	14	8	15	6	6	6	16	8	17	8	18	6	6	12
5	6	6	6	19	6	6	6	13	6	6	6	6	6	6	12
5	6	6	6	16	8	20	8	21	6	6	22	23	24	6	12
5	6	6	6	13	6	6	6	6	22	23	25	26	27	6	12
5	6	6	28	16	28	18	8	9	29	9	8	30	31	6	12
5	6	28	28	13	28	28	6	13	31	6	6	6	31	6	12
5	6	28	28	32	8	9	8	33	34	23	23	23	25	6	12
35	36	36	36	36	36	36	36	36	36	36	36	36	36	36	37
1	1	1	1	1	1	1	1	1	1	1	1	1	1	1	1